W W W W W W W W W W W W W W W W W W W W
W O O O O O O O O O O O O O O O O O E W
W O O O O O O O O O O O O O O O O O O W
W O O O W W W O O O O O W W W O O O O W
W O O O W A W O O O O O W A W O O O O W
W O O O W W W O O O O O W W W O O O O W
W O O O O O O O O O O O O O O O O O O W
W O O O O O O O O F O O O O O O O O O W
W O O O O O O O O O O O O O O O O O O W
W O O O W W W O O O O O W W W O O O O W
W O O O W A W O O O O O W A W O O O O W
W O O O W W W O O O O O W W W O O O O W
W O O O O O O O O O O O O O O O O O O W
W O O O O O O O O O O O O O O O O O O W
W E O O O O O O O O O O O O O O O O E W
W W W W W W W W W W W W W W W W W W W W
